MMMMMMMMMM
MMMVVVVMMM
MMRVVVVBMM
MVVVVVVVVM
MVVVVVVVVM
MVVVVVVVVM
MVVVVVVVVM
MMBVVVVRMM
MMMVVVVMMM
MMMMMMMMMM