MMMMMMMMM
MRVVVVVBM
MVVVVVVVM
MVVVVVVVM
MVVVVVVVM
MVVVVVVVM
MVVVVVVVM
MBVVVVVRM
MMMMMMMMM