MMMMMMMMMMM
MRVVVVVVVBM
MVMMVVVMMVM
MVMVVVVVMVM
MVVVVVVVVVM
MVVVVMVVVVM
MVVVVVVVVVM
MVMVVVVVMVM
MVMMVVVMMVM
MBVVVVVVVRM
MMMMMMMMMMM