MMMMMMMMMMM
MMMVVRVVMMM
MMMVVMVVMMM
MVVVVMVVVVM
MVVVVMVVVVM
MBMMMMMMMBM
MVVVVMVVVVM
MVVVVMVVVVM
MMMVVMVVMMM
MMMVVRVVMMM
MMMMMMMMMMM