MMMMMMMMM
MRVVVVVBM
MVVVVVVVM
MVVMVMVVM
MVVVVVVVM
MVVMVMVVM
MVVVVVVVM
MBVVVVVRM
MMMMMMMMM